wwwwwwwwwwwwwwwww
wgggggggegggggggw
wg             gw
wg wwwww wwwww gw
wg w         w gw
wg w   www   w gw
wg w         w gw
wg w w     w w gw
wg   w  P  w   gw
wg w w     w w gw
wg w         w gw
wg w   www   w gw
wg w         w gw
wg wwwww wwwww gw
wg             gw
wgggggggSgggggggw
wwwwwwwwwwwwwwwww