wwwwwwwwwwwwwwwww
wgggggggEgggggggw
wg             gw
wg wwwww wwwww gw
wg w         w gw
wg w   www   w gw
wg w         w gw
wg w wgggggw w gw
wg   wggPggw   gw
wg w wgggggw w gw
wg w         w gw
wg w   www   w gw
wg w         w gw
wg wwwww wwwww gw
wg             gw
wgggggggSgggggggw
wwwwwwwwwwwwwwwww