wwwwwwwwwwwwwwwww
wggggggg gggggggw
wg             gw
wg wwwww wwwww gw
wg w         w gw
wg w         w gw
wg w         w gw
wg w         w gw
wg      P      gw
wg w         w gw
wg w         w gw
wg w         w gw
wg w         w gw
wg wwwww wwwww gw
wg             gw
wgggggggSgggggggw
wwwwwwwwwwwwwwwww